R 1920 1080

WE ./textures/brickW.xpm
EA ./textures/brickE.xpm
NO ./textures/brickN.xpm
SO ./textures/brickS.xpm

S ./textures/sprite.xpm
F 100,200,100
C 225,30,0

        1111111111111111111111111
        1000000001100000000000001
        1011000001110020202020201
        1001000000000000000000001
111111111011000001110000002000001
100000000011000001110111100011111
11110111111111011100000010200
11110111111111011101010010001
11000000110101011100000010001
10002000000000001100000010001
11000001110101011111011110N0111
11110111 1110101 101111010001
11111111 1111111 111111111111