R 1920 1080

NO ./textures/brickN.xpm
SO ./textures/brickS.xpm
WE ./textures/brickW.xpm
EA ./textures/brickE.xpm
EA ./textures/brickE.xpm

S ./textures/sprite.xpm
F 100,200,100
C 225,30,0

11111111111
10000000001
10000000001
10000000001
10000200001
10000000001
10020N02001
10000000001
10000200001
10000000001
10000200001
10000000001
11111111111